13394, 1
14384, 1
14498, 1
14502, 1
14494, 1
14751, 2
14499, 4
14750, 1
14752, 2
